[[[[[[[[[[[[[[[[[[[[[[[[[[[[[[[[[[[[[[[[[[
[    [       [  [  [     [     [  [[     [
[        [[     [     [     [  [      [  [
[   [[[[[[[[[[  [  [[[[[[[  [  [[[  [[[  [
[   [           [        [     [      [  [
[   [   [[[  [  [  [[[[  [  [  [  [[  [  [
[   [[[[[[[  [     [     [  [     [[  [  [
[   [     [  [[[[  [  [[[[  [[[[[[[[     [
[   [     [        [           [  [[     [
[   [  [  [  [[[[[[[  [[[[  [  [      [  [
[      [     [           [  [  [[[[[[[[  [
[[[[[  [     [  [[[[[[[  [  [        [[  [
[         [  [        [     [  [[[[  [[  [
[  [[  [  [  [[[[[[[[[[  [  [  [  [      [
[      [  [              [     [         [
[[[[[[[[[[[[[[[[[[[[[[[[[[[[[[[[[[[[[[[[[[